		   
R        1200   720    		                          

NO    ./textures/wall_a4.xpm
SO     ./textures/wall_a5.xpm

WE      ./textures/wall_a7.xpm

EA       ./textures/wall_a3.xpm
S         ./textures/sprite_a1.xpm

F       33,   68,     25
C    		52	,    1,    88						






111111111111111111111111111111111111111111
120200020000000000000000000020000000000001
100000000000000000000000000000000000002001
10000000000000E000000000000000000000000001
120000000000000000000000000020000000000001
100001111111111111111111111111111111100001
100001                              100001
100001     111111                   100001
100001        111                   100001
100001      111                     100001
120001     111111           11      100001
100001                      11      100001 
100021                      11      100001
100001                      11      100001
100001                              120001
100001111111111111111111111111111111100001
100000000000200000000000000000000000000001
100000000000000000000000000000000000000001
120000000000000000000200000000000200000001
100000000000000200000000000000000000020001
111111111111111111111111111111111111111111










