
R 1080    720
NO              ./textures/wall_a4.xpm
SO             ./textures/wall_a5.xpm
WE            ./textures/wall_a7.xpm
EA            ./textures/wall_a3.xpm
S            ./textures/sprite_a3.xpm
F  8,   80,     12

C 0,   191,    252






111111111111111111111111111111111
        1000000000110000000000001
        1011000001110000002000001
        1001000000000000000000001
111111111011000001110000000000001
100000000011000001110111111111111
11110111111111011100000010001
11110111111111111101010010001
1100000011      1100010010001
1000000001      1100001E00201
1000000001      1101010100201
1100000111111111111101111020111
11110111 1110101 101111010001
11111111 1111111 111111111111




