
NO  ./textures/wall_a4.xpm
SO  ./textures/wall_a6.xpm
WE   ./textures/wall_a3.xpm
EA ./textures/wall_a1.xpm
S  ./textures/sprite_a2.xpm
R 840    680
C 0,191,    252
F 8,   80,     12





1111111111111111111
1000000000000000001
1000000000010000001
1000001100110200001
1000W00000110000001
1020000000000000001
1000000111110000001
1111111111111111111




